XXXXXXXXXXXXXXXX
X         X     
X     X   X XXXX
X XXX XXX X X  X
X X X   X X XX X
X X XXX X X X  X
X X X X X X X XX
X X X X  X  X  X
X X   XX   XXX X
X XXX   XXX    X
X              X
XXX XXXXXX X X X
X X X    X X X X
X X X XXXX X X X
X   X      X X X
XXXXXXXXXXXXXX X